NO ./textures/wall_north.xpm
SO ./textures/wall_south.xpm
WE ./textures/wall_east.xpm
EA ./textures/wall_west.xpm

F 220,100,0
C 225,30,0

111111111111111111
110000001101011111
10000000N000000011
100000000000000011
111111111111111111