NO ./textures/wall_north.xpm
SO ./textures/wall_south.xpm
WE ./textures/wall_west.xpm
EA ./textures/wall_east.xpm

F 220,100,0
C 225,30,0

111111111111111111
110000001101011111
100000000000000011
100000000000000011
101110001000000001
10110001E000000001
101110001100000001
101110001100000001
100000000000000001
111111111111111111