NO ./textures/wall_north.xpm
SO ./textures/wall_south.xpm
WE ./textures/wall_east.xpm
EA ./textures/wall_west.xpm

F 220,100,0
C 225,30,0

111111111
111211111
100000001
100000002
1000N0001
100000001
100000001
100000001
111111111