NO ./textures/v2_north.xpm
SO ./textures/v2_south.xpm
WE ./textures/v2_west.xpm
EA ./textures/v2_east.xpm

F 220,100,0
C 225,30,0

        1111111111111111111111111
        1000000000110000000000001
        1011000001110000002000001
        1001000000200000000200001
111111111011000001110000222000001
100000000011000001110111111011111
100000000011000001112111111111111
11112111111111012000000010001
1111011111111101110100N01000111111111111111111111111111111111111111111
1100000011010101110000001000000000000000000000000000000000000000000001
1000000000000000110000002000111111111111111110000011101011111111110011
1000000000000000110101001000100000000000001000000010000000000000000001
1100000111010101111101111000111100111111111121101110000000000000000001
11110111 1110101 10111101000100000000000001101000000000000000000000001
11111111 1111111 11111111111111111111111000001000111111111111111111111
                                       11111111111